C____________d
WS___SS______S
___K______R___
M_____________
WSWWWSSWWWSSWW
