B_________DW
_S___S____SW
B__________B
_S_C_S_C__S_
M___R_R____C
WSWWWSWWWWSW