_M______M__
WWS____SWWW
___________
_M________D
WWS____SWWW
WWWXXXXWWWW