M________
W________
_________
_________
_________
_________
_________
WWWWWWWWW