_M______M__
WWS____SWWW
_M________D
WWS____SWWW
WWWXXXXWWWW