_M__S___M__
WWS____SWWW
___________
_M________D
WWS____SWWW
WWWXSXXWWWW